###########################################################
#                                                         #
#                                                         #
#                                                         #
#                                                         #
#                                                         #
#                                                         #
#              ##########                                 #
#                                                         #
#                                                         #
#                                                         #
#                                       #                 #
#                                       #                 #
#                                       #                 #
#                                       #                 #
#                          ##############                 #
#                                                         #
#                                                         #
#                                                         #
###########################################################