##################################################################################################################################################################
#                                       #                                                                                                                        #
#                                       #                                                                                                                        #
#                                       #                                                                                                                        #
#                                       #           ###############################                  #                 ########                                  #
#                                       #                              #                             #                        #                                  #
#                                       #                              #                             #                        #                                  #
#                                       #                              #                             #                        ##############        ##############
#                                       #                              #                   #####################                                                 #
#                                                                      #                                                                                         #
#                                                                                                                                                                #
#                                                                                                                                                                #
#                                                                                                                                                                #
#                                                                                                                                                                #
#                                                                                                                                                                #
#                                                                                                                                                                #
#                                                              #####################                                                                             #
#                                                                                                                                                                #
#################                                                                                                                                                #
#               #                                                                                                             #                                  #
#               #                                #                                                                            #                                  #
#                                                #                                                                            #                                  #
#                                                #                           #                             ##########         ####      ##########################
#                                                #                           #                                                #                                  #
#            #####################################                           #                                                #                                  #
#                                                                            #######################                          #                                  #
#                                                                                                                             #                                  #
#                                                                                                                             #            #########             #
#                                                                                                                             #            #       #             #
#                                                                    #####################                                    #            #       #             #
#                                                                ####                                                         #            #########             #
#                                                           #####                                                             #                                  #
#########################           ##                                                                                        #                                  #
#                                   ##                                                                                                                           #
#                                   ####                                                                                                                         #
#                                      #                    ##################################                                       #####################       #
#                                      #                    #                                                                                                    #
#                                      #                    #                                                                                                    #
#                                      #                    #                                                             #                                      #
#                                      #                    #                               ########                      #                                      #
#                                      #                    #                                      #                      #                                      #
#                       ################                    #                                      #                      #                                      #
#                                                                                                  #                                                             #
#                                                                                                  #                                                             #
#                                                                                                  #                                                             #
##################################################################################################################################################################  